1111111111111111111111111111111111
1E0P000C0000E00C00000C0000C0000011
1010010100100000101001000000010101
1010010010101010001001000000010101
100C000000C000000C000000C00EE0C001
1111111111111111111111111111111111
