1111111111111111111111111111111111
1E00000E0E00C00000EE0000E00C0C0C01
1010010010101010001001000000010101
1P00C0E0C00E000CC00C0E0000C00C0C01
1111111111111111111111111111111111
