111111111
100E00001
10P0C0001
111111111
