1111111111111111111111111111111111
1E00000C0000E00C00000C0000C0000011
1010010100100000101001000000010101
1010010010101010001001000000010101
1P00C0000C00C000000C000000C00000C1
1111111111111111111111111111111111
